1111111111
1000100001
1000111001
1000001001
10P0000001
1000000001
1000000E01
1000000001
100000C001
1111111111
