1111111111
1000100001
1000111001
1000001001
1000000001
1000000001
1000000E01
10000C0001
100000P001
1111111111
