1111111111111
10100C00C0001
1000111111011
1P001E0000001
1111111111111
