1111111111111
10100C00C0001
1000111111011
1P001E00000C1
1111111111111